############
#  T       #
# P   B T  #
#  B   #####
#      #
#  B   #
#    T #
########
