##########
#        #
# P  BB  #
#  TTTT  #
#   BB   #
#        #
##########
