##############
#           T#
#            #
#    ####    #
#   B#  #    #
#    #  #    #
#   B#  #    #
#    ####T   #
#            #
#P           #
##############
