########
#      #
# P  T #
#  B   #
#   T  #
#  B   #
#      #
########
