##############
#           T#
# P  BB     T#
#  T  T  #####
#   BB   #
#        #
##########
